22 x 24
W W W W W W W W W W W W W W W W W W W W W W
W E E E E E E E E W E E E E E E E E E E E W
W E E E E E E E E W E E E E E E E E E E E W
W E E E E E E E E W E E E E E E E E E E E W
W E E E E E E E E D E E E E E E E E E E E W
W W W W D W W W W W W W W W W W W W W D W W
W E E E E E E W E E E E E E E E W E E E E W
W E E E E E E W E E E E E E E E W E E E E W
W E E E E E E W E E E E E E E E W E E E E W
W E E E E E E W E E E E E E E E D E E E E W
W E E E E E E W E E E E E E E E W E E E E W
W E E E E E E W E E E E E E E E W E E E E W
W E E E E E E W E E E E E E E E W E E E E W
W E E E E E E W E E E E E E E E W E E E E W
W E E E E E E W W W D W W W W W W E E E E W
W E E E E E E W E E E E E W E E E E E E E W
W E E E E E E W E E E E E W E E E E E E E W
W E E E E E E W E E E E E W E E E E E E E W
W E E E E E E D E E E E E W E E E E E E E W
W E E E E E E W E E E E E D E E E E E E E W
W E E E E E E W E E E E E W E E E E T T T W
W E E E E E E W E E E E E W E E E E T T T W
W E E E E E E W E E E E E W E E E E T T T W
W W W W W W W W W W W W W W W W W W W W W W